//MAP CONVERTED BY dmm2tgm.py THIS HEADER COMMENT PREVENTS RECONVERSION, DO NOT REMOVE
"a" = (
/turf/open/floor/mineral/titanium/blue,
/turf/closed/wall/mineral/titanium/interior,
/area/shuttle/arrival)
"e" = (
/obj/structure/closet/wardrobe/green,
/turf/open/floor/mineral/titanium/blue,
/area/shuttle/arrival)
"f" = (
/obj/machinery/power/shuttle_engine/propulsion{
	icon_state = "propulsion";
	dir = 4
	},
/turf/open/floor/plating/airless,
/area/shuttle/arrival)
"m" = (
/obj/machinery/door/airlock/titanium{
	name = "Arrivals Shuttle Airlock"
	},
/turf/open/floor/mineral/titanium/blue,
/area/shuttle/arrival)
"o" = (
/turf/closed/wall/mineral/titanium,
/area/shuttle/arrival)
"p" = (
/obj/structure/chair{
	dir = 8
	},
/turf/open/floor/mineral/titanium/blue,
/area/shuttle/arrival)
"q" = (
/obj/structure/closet/wardrobe/black,
/turf/open/floor/mineral/titanium/blue,
/area/shuttle/arrival)
"s" = (
/obj/structure/closet/wardrobe/grey,
/turf/open/floor/mineral/titanium/blue,
/area/shuttle/arrival)
"t" = (
/turf/open/floor/mineral/titanium/blue,
/area/shuttle/arrival)
"v" = (
/obj/structure/grille,
/obj/structure/window/reinforced/shuttle,
/turf/open/floor/plating,
/area/shuttle/arrival)
"E" = (
/obj/structure/closet/wardrobe/mixed,
/turf/open/floor/mineral/titanium/blue,
/area/shuttle/arrival)
"J" = (
/obj/machinery/power/shuttle_engine/propulsion{
	icon_state = "propulsion";
	dir = 4
	},
/obj/docking_port/mobile/arrivals,
/turf/open/floor/plating/airless,
/area/shuttle/arrival)
"L" = (
/obj/machinery/computer/arcade,
/turf/open/floor/mineral/titanium/blue,
/area/shuttle/arrival)
"M" = (
/obj/machinery/power/shuttle_engine/heater{
	icon_state = "heater";
	dir = 4
	},
/obj/structure/window/reinforced{
	dir = 8
	},
/turf/open/floor/plating/airless,
/area/shuttle/arrival)
"O" = (
/turf/template_noop,
/area/template_noop)

(1,1,1) = {"
O
o
o
v
o
o
O
"}
(2,1,1) = {"
O
o
a
t
a
o
O
"}
(3,1,1) = {"
O
o
p
t
p
o
O
"}
(4,1,1) = {"
o
o
o
m
o
o
o
"}
(5,1,1) = {"
o
t
t
t
t
t
o
"}
(6,1,1) = {"
m
t
p
p
p
t
o
"}
(7,1,1) = {"
o
L
t
t
t
t
o
"}
(8,1,1) = {"
o
e
p
p
p
t
o
"}
(9,1,1) = {"
v
q
t
t
t
t
o
"}
(10,1,1) = {"
v
E
p
p
p
t
o
"}
(11,1,1) = {"
o
s
t
t
t
t
o
"}
(12,1,1) = {"
o
L
p
p
p
t
o
"}
(13,1,1) = {"
m
t
t
t
t
t
o
"}
(14,1,1) = {"
o
o
M
M
M
o
o
"}
(15,1,1) = {"
o
f
f
J
f
f
o
"}
