//MAP CONVERTED BY dmm2tgm.py THIS HEADER COMMENT PREVENTS RECONVERSION, DO NOT REMOVE
"a" = (
/turf/template_noop,
/area/template_noop)
"c" = (
/obj/machinery/door/airlock/titanium,
/obj/docking_port/mobile{
	dir = 8;
	dwidth = 2;
	height = 12;
	id = "ferry";
	name = "ferry shuttle";
	roundstart_move = "ferry_away";
	port_angle = 180;
	width = 5
	},
/turf/open/floor/mineral/titanium/blue,
/area/shuttle/transport)
"d" = (
/obj/structure/chair{
	dir = 4
	},
/turf/open/floor/mineral/titanium/blue,
/area/shuttle/transport)
"g" = (
/obj/structure/chair{
	dir = 1
	},
/turf/open/floor/mineral/titanium/blue,
/area/shuttle/transport)
"h" = (
/obj/machinery/door/airlock/titanium,
/turf/open/floor/mineral/titanium/blue,
/area/shuttle/transport)
"i" = (
/obj/machinery/power/shuttle_engine/propulsion{
	icon_state = "propulsion";
	dir = 8
	},
/turf/closed/wall/mineral/titanium/overspace,
/area/shuttle/transport)
"n" = (
/obj/structure/grille,
/obj/structure/window/reinforced/shuttle,
/turf/open/floor/plating,
/area/shuttle/transport)
"p" = (
/obj/structure/chair,
/turf/open/floor/mineral/titanium/blue,
/area/shuttle/transport)
"x" = (
/obj/structure/window/reinforced/shuttle,
/obj/structure/grille,
/turf/open/floor/plating,
/area/shuttle/transport)
"B" = (
/turf/open/floor/mineral/titanium/blue,
/area/shuttle/transport)
"L" = (
/obj/machinery/computer/shuttle/ferry/request{
	dir = 8
	},
/turf/open/floor/mineral/titanium/blue,
/area/shuttle/transport)
"T" = (
/turf/closed/wall/mineral/titanium,
/area/shuttle/transport)
"U" = (
/obj/structure/closet/crate,
/turf/open/floor/mineral/titanium/blue,
/area/shuttle/transport)
"W" = (
/turf/open/floor/mineral/titanium/blue,
/turf/closed/wall/mineral/titanium/interior,
/area/shuttle/transport)

(1,1,1) = {"
a
i
h
i
a
"}
(2,1,1) = {"
i
W
B
W
i
"}
(3,1,1) = {"
T
d
B
U
T
"}
(4,1,1) = {"
T
L
B
U
T
"}
(5,1,1) = {"
x
p
B
g
x
"}
(6,1,1) = {"
T
p
B
g
T
"}
(7,1,1) = {"
T
p
B
g
T
"}
(8,1,1) = {"
T
p
B
g
T
"}
(9,1,1) = {"
n
p
B
g
n
"}
(10,1,1) = {"
T
p
B
g
T
"}
(11,1,1) = {"
T
p
B
g
T
"}
(12,1,1) = {"
T
x
c
x
T
"}
