//MAP CONVERTED BY dmm2tgm.py THIS HEADER COMMENT PREVENTS RECONVERSION, DO NOT REMOVE
"a" = (
/turf/closed/wall/mineral/titanium,
/area/shuttle/mining)
"d" = (
/obj/structure/chair{
	dir = 1
	},
/turf/open/floor/mineral/plastitanium/red,
/area/shuttle/mining)
"g" = (
/obj/machinery/power/shuttle_engine/heater,
/obj/structure/window/reinforced{
	dir = 4
	},
/obj/structure/window/reinforced{
	dir = 1
	},
/obj/structure/window/reinforced{
	dir = 8
	},
/turf/open/floor/plating/airless,
/area/shuttle/mining)
"m" = (
/obj/structure/table,
/turf/open/floor/mineral/plastitanium/red,
/area/shuttle/mining)
"v" = (
/obj/machinery/power/shuttle_engine/propulsion/burst,
/obj/structure/window/reinforced{
	dir = 1;
	layer = 2.9
	},
/turf/open/floor/plating/airless,
/area/shuttle/mining)
"D" = (
/obj/machinery/door/airlock/titanium{
	name = "Mining Shuttle Airlock";
	req_access_txt = "0"
	},
/obj/docking_port/mobile{
	dir = 8;
	dwidth = 3;
	height = 5;
	id = "mining";
	name = "mining shuttle";
	port_angle = 270;
	width = 7
	},
/turf/open/floor/plating,
/area/shuttle/mining)
"K" = (
/turf/open/floor/mineral/plastitanium/red,
/area/shuttle/mining)
"R" = (
/obj/structure/grille,
/obj/structure/window/reinforced/shuttle,
/turf/open/floor/plating,
/area/shuttle/mining)
"X" = (
/obj/machinery/computer/shuttle/mining,
/turf/open/floor/mineral/plastitanium/red,
/area/shuttle/mining)
"Z" = (
/obj/structure/ore_box,
/turf/open/floor/mineral/plastitanium/red,
/area/shuttle/mining)

(1,1,1) = {"
a
a
R
a
R
a
a
"}
(2,1,1) = {"
a
m
K
K
d
Z
a
"}
(3,1,1) = {"
R
X
d
K
d
g
v
"}
(4,1,1) = {"
a
m
K
K
d
Z
a
"}
(5,1,1) = {"
a
a
R
D
R
a
a
"}
